...................#
.....###########....
...............#....
...............#....
..#.................
....................
....................
....................
....................
.....#######........
....................
....................
....................
.#..................
.#..................
.#..................
.#..................
....................
....................
#..................#