....................
.#######............
..............#.....
..#...........#.....
..#...........#.....
..............###...
...###..............
....................
....................
....................
..............###...
....##..............
....##..............
....##..............
....................
..............###....
....................
....................
...#....#...........
...#....#...........